Team,Played,Won,Lost,Points,Rubbers For,Rubbers Against
Sha Tin 5,12,12,0,56,44,16
The Squash Club 3,13,8,5,46,38,27
Kinetic 3,12,10,2,45,35,25
Tuen Mun Squash Club,13,7,6,39,32,33
Global Squash 2,13,6,7,39,33,32
HKCC Tuesday Night Rockers,12,6,6,37,31,29
Star River 1,14,5,9,37,32,38
BOSS,11,6,5,36,30,25
i-Mask Advance Squash Club 4,11,4,7,28,24,31
7NT,12,2,10,24,22,38
Invader Squash,13,2,11,21,19,46
