Position,Name of Player,Team,Average Points,Total Game Points,Games Played,Won,Lost,Division,Win Percentage
1,Tse Ka Chun,X-Alpha 4,26.62,213,8,8,0,17A,1.0
2,Leung Ka Hei,i-Mask Advance Squash Club 8,24.27,267,11,10,1,17A,0.9090909090909091
3,Shapiro William Dat,Vitality Squash 2,21.75,261,12,9,3,17A,0.75
4,Yang Sihan,Fusion Squash Club 2,21.0,168,8,6,2,17A,0.75
4,Yang Ho Yin,Happy Squash 3,21.0,189,9,6,3,17A,0.6666666666666666
6,Leung Ngo San,Fusion Squash Club 2,21.0,105,5,5,0,17A,1.0
7,Chan Yan Chau,Smart Squash 2,20.77,270,13,7,6,17A,0.5384615384615384
8,Luo Wan Hei,Fusion Squash Club 2,20.33,183,9,6,3,17A,0.6666666666666666
9,Mei Tian Xiao,Vitality Squash 2,20.0,180,9,6,3,17A,0.6666666666666666
10,Mo Shing Tsang,X-Alpha 4,19.33,174,9,8,1,17A,0.8888888888888888
11,Mao Junhong,Fusion Squash Club 2,19.29,135,7,5,2,17A,0.7142857142857143
12,Tin Chung Hei,X-Alpha 4,19.0,171,9,9,0,17A,1.0
13,Ho Ho Lai,X-Alpha 4,18.9,189,10,9,1,17A,0.9
14,Wong Adrian Preston,X-Alpha 4,18.86,132,7,6,1,17A,0.8571428571428571
15,Kollar Thomas,Vitality Squash 2,18.75,150,8,6,2,17A,0.75
16,Lee Hok Chung,Smart Squash 2,18.55,204,11,7,4,17A,0.6363636363636364
17,Li Kin Lok,Happy Squash 3,18.5,111,6,2,4,17A,0.3333333333333333
18,Chan Sze Long,X-Alpha 4,18.38,147,8,8,0,17A,1.0
19,Lau Hiu Wing,X-Alpha 4,18.0,180,10,9,1,17A,0.9
20,Yau Lucas Haoxiang,i-Mask Advance Squash Club 8,18.0,90,5,3,2,17A,0.6
21,Ho Chin Pok,X-Alpha 4,17.67,159,9,7,2,17A,0.7777777777777778
22,Chiu Dustin,Fusion Squash Club 2,17.14,120,7,6,1,17A,0.8571428571428571
23,Li Wen Ying,i-Mask Advance Squash Club 7,17.14,120,7,2,5,17A,0.2857142857142857
24,Wong Wang Ching,Friend Club 6,16.2,162,10,4,6,17A,0.4
25,Tse Tin Yui,Smart Squash 2,16.12,129,8,5,3,17A,0.625
26,Cheung Hiu Man,Fusion Squash Club 2,15.82,174,11,9,2,17A,0.8181818181818182
27,Chan One,Smart Squash 2,15.6,78,5,4,1,17A,0.8
28,Hung Wai Chun,i-Mask Advance Squash Club 8,15.6,78,5,3,2,17A,0.6
29,Cheung Ying Yat,Fusion Squash Club 2,15.6,78,5,2,3,17A,0.4
30,Li Ying Huen,i-Mask Advance Squash Club 7,15.0,120,8,4,4,17A,0.5
31,Lam Yan Yu Hayley,i-Mask Advance Squash Club 7,15.0,75,5,2,3,17A,0.4
32,Leung Shun Hei,Happy Squash 3,14.75,177,12,4,8,17A,0.3333333333333333
33,Man Yu Hin,Smart Squash 2,13.71,96,7,3,4,17A,0.42857142857142855
34,Cheung Yee Ki,Happy Squash 3,13.64,150,11,5,6,17A,0.45454545454545453
35,Lee Yin Fung,Friend Club 6,13.29,93,7,1,6,17A,0.14285714285714285
36,Tam Ming Wai,Friend Club 6,13.2,66,5,4,1,17A,0.8
37,Cheng Adam Ho Ching,Fusion Squash Club 2,13.09,144,11,9,2,17A,0.8181818181818182
38,Hung Wai Tung,i-Mask Advance Squash Club 8,12.0,72,6,4,2,17A,0.6666666666666666
38,Chen Mickey Youlin,Vitality Squash 2,12.0,108,9,4,5,17A,0.4444444444444444
40,Lau Cheuk Yan,Happy Squash 3,11.4,57,5,4,1,17A,0.8
41,Lau Sze Tung,Happy Squash 3,10.29,144,14,8,6,17A,0.5714285714285714
42,Kwong Wai Ching,Happy Squash 3,9.92,129,13,4,9,17A,0.3076923076923077
43,Tsoi Cheuk Hin Kieran,i-Mask Advance Squash Club 8,9.82,108,11,1,10,17A,0.09090909090909091
44,Au Pak Yin,i-Mask Advance Squash Club 8,9.6,48,5,3,2,17A,0.6
45,Cheung Hoi Ying,Smart Squash 2,8.67,78,9,4,5,17A,0.4444444444444444
46,Xie Yu Hin,i-Mask Advance Squash Club 7,8.4,42,5,1,4,17A,0.2
47,Lam Tsz Yan,Friend Club 6,8.14,57,7,3,4,17A,0.42857142857142855
48,Luk Argen,Vitality Squash 2,8.1,81,10,5,5,17A,0.5
49,Sun Jacob Jia-Wei,Vitality Squash 2,7.8,39,5,1,4,17A,0.2
50,Tse Tin Yiu,Smart Squash 2,7.5,60,8,4,4,17A,0.5
51,Rui Wen Huang,i-Mask Advance Squash Club 7,7.2,36,5,1,4,17A,0.2
52,Chan Ming Hei,Smart Squash 2,7.12,57,8,2,6,17A,0.25
53,Wong Tze Tang,i-Mask Advance Squash Club 8,7.0,63,9,2,7,17A,0.2222222222222222
54,Wong Wun Yin,i-Mask Advance Squash Club 7,5.57,39,7,1,6,17A,0.14285714285714285
55,Choi Pui Ho,Friend Club 6,5.5,33,6,0,6,17A,0.0
56,Chen Marshall Youpeng,Vitality Squash 2,5.0,30,6,1,5,17A,0.16666666666666666
57,Chung Lincoln Sing Fun,i-Mask Advance Squash Club 8,4.2,21,5,1,4,17A,0.2
58,Kwok Ho Ching,Friend Club 6,0.6,3,5,0,5,17A,0.0
,Lam Lucas,Fusion Squash Club 2,27.0,27,1,1,0,17A,1.0
,Chan Yik Hei,Vitality Squash 2,20.0,60,3,3,0,17A,1.0
,Lai Wing Sze,i-Mask Advance Squash Club 7,18.0,18,1,0,1,17A,0.0
,Bei Chi Ting,Vitality Squash 2,15.0,15,1,1,0,17A,1.0
,Lui Pakying Jaclyn,Vitality Squash 2,14.25,57,4,2,2,17A,0.5
,Tang Ching On,Fusion Squash Club 2,13.0,39,3,3,0,17A,1.0
,Lam Cheuk Hei,Friend Club 6,12.75,51,4,2,2,17A,0.5
,Lam Cheuk Yin,Friend Club 6,12.75,51,4,1,3,17A,0.25
,Wong Ching Ting,Friend Club 6,12.0,36,3,1,2,17A,0.3333333333333333
,Lin Lee Ping,i-Mask Advance Squash Club 7,10.5,21,2,1,1,17A,0.5
,Lo Chun Hin Alston,Friend Club 6,9.75,39,4,1,3,17A,0.25
,Hui Cheuk Him Brody,Friend Club 6,9.0,36,4,0,4,17A,0.0
,Kwan Hoi Ching,Friend Club 6,8.0,24,3,0,3,17A,0.0
,Wong Tsz Long,i-Mask Advance Squash Club 7,6.0,12,2,0,2,17A,0.0
,Ho Lok Hang,Happy Squash 3,0.0,0,0,0,0,17A,
,Chen Yat Kuen,i-Mask Advance Squash Club 7,0.0,0,0,0,0,17A,
