Position,Name of Player,Team,Average Points,Total Game Points,Games Played,Won,Lost,Division,Win Percentage
1,Chow Pui Sing,Bravo D13,25.83,465,18,17,1,13A,0.9444444444444444
2,Luk Hoi Fai,TNG 1,24.3,243,10,10,0,13A,1.0
3,Wu Chi Wai,Arctic Circle,23.6,354,15,12,3,13A,0.8
4,Cheung Chor Yu,TNG 2,22.93,321,14,11,3,13A,0.7857142857142857
5,Hung Wai Chun,TNG 1,22.2,222,10,9,1,13A,0.9
6,Tang Ka Yan,M&M Squash,21.67,195,9,6,3,13A,0.6666666666666666
7,Cao Yu,TNG 2,21.55,237,11,9,2,13A,0.8181818181818182
8,Tam Tsz Lung,TNG 1,21.46,279,13,9,4,13A,0.6923076923076923
9,Yip Edmund Kin Man,Star River 3,21.38,171,8,5,3,13A,0.625
10,Leung Ka Luen Wilson,Squashathon PLZ,20.62,330,16,10,6,13A,0.625
11,Tse Ray,Royal Hong Kong Yacht Club Div 13,20.45,225,11,8,3,13A,0.7272727272727273
12,Leung Hok Sum,Squashathon PLZ,20.0,240,12,9,3,13A,0.75
13,Koon Long Ying,TNG 2,19.8,198,10,9,1,13A,0.9
14,Chan Kwok Wa,Greenfield,19.76,336,17,15,2,13A,0.8823529411764706
15,Chen Ricky C,Royal Hong Kong Yacht Club Div 13,19.0,114,6,3,3,13A,0.5
16,Kwok Yau Yau,TNG 1,18.6,186,10,9,1,13A,0.9
17,Chow Ka Lun,Squashathon PLZ,18.21,255,14,9,5,13A,0.6428571428571429
18,Yuen Lok Hang,Physical Chess 4,18.0,306,17,14,3,13A,0.8235294117647058
19,Lai Yiu Wa,Greenfield,18.0,252,14,7,7,13A,0.5
20,Theil Rene,Royal Hong Kong Yacht Club Div 13,18.0,90,5,3,2,13A,0.6
20,Chan Yik Hei,Vitality Squash 3,18.0,108,6,3,3,13A,0.5
22,Zhang Ruitao,Bravo D13,17.67,159,9,6,3,13A,0.6666666666666666
23,Loo Long Hui,Squashathon PLZ,17.5,105,6,5,1,13A,0.8333333333333334
24,Wong Pak Yiu,TNG 1,17.25,138,8,6,2,13A,0.75
25,Choi Ming Fung,Arctic Circle,16.67,150,9,4,5,13A,0.4444444444444444
26,Yip Benjamin,Royal Hong Kong Yacht Club Div 13,16.5,198,12,9,3,13A,0.75
27,Young Ki Chun,Greenfield,16.5,99,6,2,4,13A,0.3333333333333333
28,Chan Shun Ting,TNG 2,16.29,228,14,10,4,13A,0.7142857142857143
29,Chen Mickey Youlin,Vitality Squash 3,16.25,195,12,2,10,13A,0.16666666666666666
30,Wai Veronica Chi Man,Star River 3,16.07,225,14,11,3,13A,0.7857142857142857
31,Chan Hong Ting,TNG 2,16.0,240,15,15,0,13A,1.0
32,Wong Tsz Hei,Greenfield,15.67,141,9,2,7,13A,0.2222222222222222
33,Clayton Iain Michael,Royal Hong Kong Yacht Club Div 13,15.56,249,16,8,8,13A,0.5
34,Dogra Vijendra Singh Balbirsing,North District Sports Association 2,15.5,186,12,10,2,13A,0.8333333333333334
35,Lam Ngo Sze Osee,M&M Squash,15.43,216,14,6,8,13A,0.42857142857142855
36,Cheung Brian Sheung Yan,Arctic Circle,15.0,165,11,8,3,13A,0.7272727272727273
37,Tam Rony Kwok Ki,Star River 3,14.77,192,13,3,10,13A,0.23076923076923078
38,Yung Kerri Ka Lam,Physical Chess 4,14.67,132,9,2,7,13A,0.2222222222222222
39,Wong Wing Hing,TNG 1,14.62,117,8,4,4,13A,0.5
40,Hui Tak Cheung,Greenfield,14.4,144,10,7,3,13A,0.7
41,Zirah Pierre-Alexis Joachim,Royal Hong Kong Yacht Club Div 13,14.2,213,15,11,4,13A,0.7333333333333333
42,Leung Keith Koon Chung,Royal Hong Kong Yacht Club Div 13,13.71,96,7,6,1,13A,0.8571428571428571
42,Bai Yuet,TNG 1,13.71,96,7,6,1,13A,0.8571428571428571
44,Wong Kelvin Ka Wing,Squashathon PLZ,13.71,96,7,4,3,13A,0.5714285714285714
45,Ku Wing Gi Vingi,Physical Chess 4,13.71,96,7,1,6,13A,0.14285714285714285
46,Chen Marshall Youpeng,Vitality Squash 3,13.62,177,13,9,4,13A,0.6923076923076923
47,Sun Jacob Jia-Wei,Vitality Squash 3,13.5,81,6,4,2,13A,0.6666666666666666
48,Lam Wai,Greenfield,13.38,174,13,9,4,13A,0.6923076923076923
49,Wong Wai Ling Helen,Arctic Circle,13.07,183,14,5,9,13A,0.35714285714285715
50,Tsoi Cheuk Hin Kieran,Vitality Squash 3,13.0,195,15,3,12,13A,0.2
51,Ku Desmond Yuk Yan,Greenfield,12.9,129,10,9,1,13A,0.9
52,Choi Hiu Long,Arctic Circle,12.75,153,12,9,3,13A,0.75
53,Kwok To Yan,TNG 1,12.69,165,13,11,2,13A,0.8461538461538461
54,Tsang Man Chiu,North District Sports Association 2,12.46,162,13,10,3,13A,0.7692307692307693
55,Luk Argen,Vitality Squash 3,12.38,198,16,7,9,13A,0.4375
56,Koon Ting Kong,TNG 2,12.38,99,8,4,4,13A,0.5
57,Cheung Sky,TNG 1,12.27,135,11,7,4,13A,0.6363636363636364
58,Wong Marcus,M&M Squash,12.23,159,13,10,3,13A,0.7692307692307693
59,Lai Ming Yau Martin,Arctic Circle,12.0,132,11,6,5,13A,0.5454545454545454
60,Lee Yui Hin,North District Sports Association 2,12.0,84,7,3,4,13A,0.42857142857142855
60,Leung Yat Hei,North District Sports Association 2,12.0,192,16,3,13,13A,0.1875
62,Chen Haoyuan,M&M Squash,12.0,144,12,1,11,13A,0.08333333333333333
63,Chan Hong Lam,North District Sports Association 2,11.79,165,14,7,7,13A,0.5
64,Wong Bao Kwong Chi,Star River 3,11.62,186,16,1,15,13A,0.0625
65,Leung Venus Wing Sze,Star River 3,11.36,159,14,4,10,13A,0.2857142857142857
66,Chiu Kenny Kwun Chark,Royal Hong Kong Yacht Club Div 13,10.88,87,8,3,5,13A,0.375
67,Zhou Cheng  Yuan,M&M Squash,10.85,141,13,3,10,13A,0.23076923076923078
68,Cheung Hoi Suen,Squashathon PLZ,10.5,63,6,4,2,13A,0.6666666666666666
69,Chung Wing Yin,Squashathon PLZ,10.12,81,8,3,5,13A,0.375
70,Chow Maxwell,North District Sports Association 2,10.0,60,6,3,3,13A,0.5
71,Ching Pak Hin,Squashathon PLZ,9.6,48,5,2,3,13A,0.4
72,Pan Dan,Bravo D13,9.55,105,11,2,9,13A,0.18181818181818182
73,Yau Tsz Hin,Arctic Circle,9.25,111,12,6,6,13A,0.5
74,Hong Hang Shan,Arctic Circle,9.0,54,6,1,5,13A,0.16666666666666666
75,Lau Ted Hei Yuen,Greenfield,8.57,60,7,2,5,13A,0.2857142857142857
76,Keung Olive Man Yee,Star River 3,7.38,96,13,3,10,13A,0.23076923076923078
77,Chan Hin Chiu,Squashathon PLZ,7.2,36,5,1,4,13A,0.2
78,Guo Wan Ling,Bravo D13,7.09,78,11,2,9,13A,0.18181818181818182
79,Zhang Fei,Bravo D13,7.09,78,11,1,10,13A,0.09090909090909091
80,Yim Yu Tak,M&M Squash,7.0,105,15,2,13,13A,0.13333333333333333
81,Lam Chun Lok,TNG 2,6.46,84,13,4,9,13A,0.3076923076923077
82,Xie Zhaona,Bravo D13,5.4,27,5,1,4,13A,0.2
83,Tong Juan,Bravo D13,5.25,42,8,2,6,13A,0.25
84,Chan Cheuk Nam,Physical Chess 4,4.5,72,16,0,16,13A,0.0
85,Cheng Hilda Shun San,Star River 3,4.15,54,13,3,10,13A,0.23076923076923078
86,Ho Hok Leung,Squashathon PLZ,3.6,18,5,0,5,13A,0.0
87,Wong Ho Yi,M&M Squash,3.0,33,11,2,9,13A,0.18181818181818182
88,Yang Xinxiao,Bravo D13,2.4,12,5,1,4,13A,0.2
,Fu Wei,Bravo D13,24.0,96,4,4,0,13A,1.0
,Chung King Long Jacqueline,TNG 2,23.0,69,3,2,1,13A,0.6666666666666666
,Onillon Jean-Charles,Royal Hong Kong Yacht Club Div 13,21.0,63,3,3,0,13A,1.0
,Lai Kid Ying,Physical Chess 4,21.0,21,1,1,0,13A,1.0
,Hung Wai Tung,TNG 1,18.0,54,3,3,0,13A,1.0
,Tang Gary Woon Cheung,Royal Hong Kong Yacht Club Div 13,18.0,36,2,2,0,13A,1.0
,Shao Bang Jie,Physical Chess 4,18.0,36,2,2,0,13A,1.0
,Lo Wing Yan,North District Sports Association 2,18.0,18,1,1,0,13A,1.0
,Wong Tsz Wang Clayton,Squashathon PLZ,18.0,18,1,1,0,13A,1.0
,Wan Yiu Hong,Physical Chess 4,18.0,18,1,1,0,13A,1.0
,Chan Kwong Ching Darren,Physical Chess 4,18.0,54,3,1,2,13A,0.3333333333333333
,Chan Siu Yuen,Royal Hong Kong Yacht Club Div 13,17.0,51,3,3,0,13A,1.0
,Goran Manojlovic,Squashathon PLZ,16.5,33,2,1,1,13A,0.5
,Ha Kong Ho Addison,Royal Hong Kong Yacht Club Div 13,15.0,45,3,3,0,13A,1.0
,Tam Hoi Man,North District Sports Association 2,15.0,30,2,2,0,13A,1.0
,Chiu Sai Kwong,Royal Hong Kong Yacht Club Div 13,15.0,15,1,1,0,13A,1.0
,Wong Ho Kai,Physical Chess 4,15.0,15,1,1,0,13A,1.0
,Cheung Hei Sun,TNG 2,15.0,15,1,1,0,13A,1.0
,Chan Yuen Hei,Physical Chess 4,15.0,15,1,1,0,13A,1.0
,Yeung Hei Lui,Squashathon PLZ,15.0,15,1,1,0,13A,1.0
,Lai Gary Kin Yeung,Physical Chess 4,14.25,57,4,2,2,13A,0.5
,Lau Hon Chu,Greenfield,14.0,42,3,2,1,13A,0.6666666666666666
,Chan King Tsz,Physical Chess 4,13.5,54,4,2,2,13A,0.5
,Ma Chi Lok Joshua,Greenfield,12.75,51,4,3,1,13A,0.75
,Chan One,Physical Chess 4,10.5,21,2,0,2,13A,0.0
,Tin Nok Lam,Physical Chess 4,9.0,9,1,1,0,13A,1.0
,Cheng King Leung,Vitality Squash 3,9.0,18,2,1,1,13A,0.5
,Wu Pat Lun Felix,Greenfield,9.0,18,2,1,1,13A,0.5
,Cheung Vinus,TNG 1,6.0,12,2,1,1,13A,0.5
,Morris Brandon Quinn,Royal Hong Kong Yacht Club Div 13,6.0,6,1,0,1,13A,0.0
,Wong Ho Tong,Physical Chess 4,6.0,6,1,0,1,13A,0.0
,Ho Yik Siu Andy,Physical Chess 4,4.5,9,2,0,2,13A,0.0
,Chan Nathan Tze Ho,Squashathon PLZ,3.0,3,1,0,1,13A,0.0
,Wong Tze Tang,Vitality Squash 3,3.0,3,1,0,1,13A,0.0
,Ho Wai Yan,Physical Chess 4,3.0,9,3,0,3,13A,0.0
,Chiu Yee Ming,Star River 3,1.5,6,4,0,4,13A,0.0
,Fung Ka Chun,Squashathon PLZ,1.5,6,4,0,4,13A,0.0
,Lai Ming Wah,Royal Hong Kong Yacht Club Div 13,0.0,0,1,0,1,13A,0.0
,Chow Qing,Squashathon PLZ,0.0,0,1,0,1,13A,0.0
,Cao Rui,Bravo D13,0.0,0,1,0,1,13A,0.0
,Wong Chi Kin,Squashathon PLZ,0.0,0,1,0,1,13A,0.0
,Yang Marcus,Bravo D13,0.0,0,1,0,1,13A,0.0
,Kang Sen Yu,Bravo D13,0.0,0,0,0,0,13A,0.0
,Chiu Hau Yi,TNG 2,0.0,0,0,0,0,13A,0.0
,Liang Kanghua,Physical Chess 4,0.0,0,0,0,0,13A,0.0
