Position,Name of Player,Team,Average Points,Total Game Points,Games Played,Won,Lost,Division,Win Percentage
1,Lin Chun Wah,Alpha CUHK,25.0,150,6,5,1,12,0.8333333333333334
2,Lo Tin Lai,North District Sports Association 1,23.5,141,6,6,0,12,1.0
3,Thambidrai Sunil James,Winter Warriors,23.5,141,6,5,1,12,0.8333333333333334
4,Ng Ngo Ching Matthew,Latecomers,22.0,132,6,4,2,12,0.6666666666666666
5,Leung Ka Lau,Alpha CUHK,19.8,99,5,4,1,12,0.8
6,Lau Douglas Kin Chung,CSD Squash Team,19.8,99,5,3,2,12,0.6
7,Lee Hoi Yu,North District Sports Association 1,19.0,114,6,2,4,12,0.3333333333333333
8,Lee Hok Chung,North District Sports Association 1,17.5,105,6,6,0,12,1.0
9,Tang Bobby Kwong Hing,Star River 2,17.0,102,6,3,3,12,0.5
10,Tsang Timmy Kwok Tim,ZOMA,15.0,90,6,4,2,12,0.6666666666666666
11,Wei Miles Abraham,Hong Kong Football Club 12B,14.4,72,5,2,3,12,0.4
12,Leung Tsun Man,North District Sports Association 1,13.5,81,6,3,3,12,0.5
13,Cheung Ken Wai Luen,ZOMA,13.5,81,6,2,4,12,0.3333333333333333
14,Chan Chi Wah,Star River 2,12.5,75,6,4,2,12,0.6666666666666666
15,Chan Edward Cheuk Wah,Star River 2,12.0,60,5,2,3,12,0.4
16,Chung Ivan Sze Chit,CSD Squash Team,12.0,72,6,1,5,12,0.16666666666666666
17,Cheung Chun Ning,Latecomers,10.2,51,5,0,5,12,0.0
18,Ho Chin Pik,Star River 2,9.0,54,6,1,5,12,0.16666666666666666
19,Chung Wai Yin,Latecomers,2.4,12,5,0,5,12,0.0
,Ho Man Lok,CSD Squash Team,26.0,78,3,3,0,12,1.0
,Leung Kam Yau Hardy,South China Athletic Association,24.0,72,3,3,0,12,1.0
,Chada Neil,Winter Warriors,24.0,72,3,3,0,12,1.0
,Yeung Karic Ying Ho,Sea Bear,24.0,24,1,1,0,12,1.0
,Chang Sean Pey,Hong Kong Racketlon Assoication 2,23.0,69,3,3,0,12,1.0
,Tai Dhubal Koon Ho,South China Athletic Association,22.5,90,4,4,0,12,1.0
,Wu Kan Wah Kit,Star River 2,22.0,66,3,2,1,12,0.6666666666666666
,Gupta Akhil,Winter Warriors,21.0,63,3,3,0,12,1.0
,Tiu Man Kit,Sea Bear,21.0,84,4,3,1,12,0.75
,Wong William Wai Ming,Hong Kong Football Club 12A,21.0,63,3,2,1,12,0.6666666666666666
,Leung Yip Kan,South China Athletic Association,21.0,42,2,2,0,12,1.0
,Lo Wing Man Veronica,Hong Kong Football Club 12B,21.0,21,1,1,0,12,1.0
,Yuen Amos Wing Keung,ZOMA,21.0,21,1,1,0,12,1.0
,Kwan Kay Ho Kelvin,Hong Kong Football Club 12A,21.0,21,1,1,0,12,1.0
,Leung Lilian Wai Shan,Sea Bear,20.0,60,3,3,0,12,1.0
,Pang Edward Sze Ho,ZOMA,19.5,78,4,2,2,12,0.5
,Wan Wan Lung,Sea Bear,19.0,57,3,3,0,12,1.0
,Cheng Chuen,South China Athletic Association,19.0,57,3,3,0,12,1.0
,Bhalothia Saksham,Winter Warriors,18.0,72,4,3,1,12,0.75
,Luk Jeffery Chi Heng,Sea Bear,18.0,72,4,2,2,12,0.5
,Chan Eric Sze Kin,South China Athletic Association,18.0,36,2,2,0,12,1.0
,Li David So Ming,ZOMA,18.0,18,1,1,0,12,1.0
,Ng Simon Chi Ming,Hong Kong Football Club 12A,16.5,66,4,4,0,12,1.0
,Mahfooz Hamza Farrukh,Winter Warriors,16.5,33,2,2,0,12,1.0
,Chen Wai Man,Alpha CUHK,16.0,48,3,3,0,12,1.0
,Chau Gordon,Winter Warriors,16.0,48,3,3,0,12,1.0
,Cheng Chen Kaja,Hong Kong Football Club 12B,16.0,48,3,2,1,12,0.6666666666666666
,Fong Yi Son,Hong Kong Football Club 12A,15.75,63,4,4,0,12,1.0
,Ho Fai,South China Athletic Association,15.75,63,4,1,3,12,0.25
,Lau Chi Wai,Alpha CUHK,15.0,60,4,3,1,12,0.75
,Hutchins Darren,Winter Warriors,15.0,45,3,2,1,12,0.6666666666666666
,Fong Kong Raymond,Hong Kong Football Club 12A,15.0,30,2,2,0,12,1.0
,Lanversin Julien,Winter Warriors,15.0,15,1,1,0,12,1.0
,Sung Stephen,Hong Kong Football Club 12A,15.0,15,1,1,0,12,1.0
,Luk Thomas Yun Tong,Alpha CUHK,15.0,15,1,1,0,12,1.0
,Ku Ken,ZOMA,15.0,15,1,0,1,12,0.0
,Lau John Wai Nang,South China Athletic Association,15.0,15,1,0,1,12,0.0
,Chew Alexander,Hong Kong Football Club 12A,13.5,54,4,1,3,12,0.25
,Feng Da Wei,Hong Kong Racketlon Assoication 2,13.5,27,2,1,1,12,0.5
,Ho Cheuk Yin,Sea Bear,13.5,54,4,0,4,12,0.0
,Kong Yuk Ki,Sea Bear,13.0,39,3,2,1,12,0.6666666666666666
,Tse Chun Kit,Hong Kong Racketlon Assoication 2,13.0,39,3,1,2,12,0.3333333333333333
,Tse Jason Tsz Chun,ZOMA,13.0,39,3,0,3,12,0.0
,Lam Francis Fu Yuen,Alpha CUHK,12.75,51,4,2,2,12,0.5
,Cheung Thomas,Hong Kong Football Club 12A,12.75,51,4,2,2,12,0.5
,Tang Chi Kin,South China Athletic Association,12.0,24,2,1,1,12,0.5
,Chan Man Fai,CSD Squash Team,12.0,24,2,1,1,12,0.5
,Ho Suet Ying,Hong Kong Racketlon Assoication 2,12.0,24,2,1,1,12,0.5
,Ha Henry Kam Bo,Alpha CUHK,12.0,24,2,1,1,12,0.5
,To Peter,South China Athletic Association,12.0,12,1,1,0,12,1.0
,Chan Christine Yik Tat,Hong Kong Football Club 12A,12.0,24,2,0,2,12,0.0
,Tang Hon Leung,Hong Kong Racketlon Assoication 2,12.0,12,1,0,1,12,0.0
,Etherington David,Hong Kong Football Club 12B,12.0,24,2,0,2,12,0.0
,Chau Phil,Hong Kong Football Club 12A,12.0,12,1,0,1,12,0.0
,Wong Shing Yin,Hong Kong Racketlon Assoication 2,12.0,36,3,0,3,12,0.0
,Tsang Ricky Wai Kit,Alpha CUHK,12.0,24,2,0,2,12,0.0
,Tan Sum Yi,Hong Kong Racketlon Assoication 2,12.0,12,1,0,1,12,0.0
,Chan Alice Yin Ling,South China Athletic Association,11.25,45,4,3,1,12,0.75
,Mitchell Aiteina,Hong Kong Football Club 12B,11.25,45,4,0,4,12,0.0
,Chiu Kwan Kin Douglas,Hong Kong Racketlon Assoication 2,11.0,33,3,1,2,12,0.3333333333333333
,Sung Iris,Hong Kong Football Club 12A,10.5,42,4,2,2,12,0.5
,Choy Siu Sang,Sea Bear,10.5,42,4,2,2,12,0.5
,Lam Arthur Chi Keung,South China Athletic Association,10.5,21,2,1,1,12,0.5
,Zhang Yiwen,Star River 2,10.0,30,3,2,1,12,0.6666666666666666
,Yu Ming Chi,Sea Bear,10.0,30,3,2,1,12,0.6666666666666666
,Tang Wai Lam,North District Sports Association 1,9.75,39,4,2,2,12,0.5
,Putt Alasdair,Hong Kong Football Club 12B,9.0,27,3,2,1,12,0.6666666666666666
,Lo Carlos Wing Hung,Alpha CUHK,9.0,27,3,2,1,12,0.6666666666666666
,Tong Man Ho,Hong Kong Racketlon Assoication 2,9.0,9,1,1,0,12,1.0
,Leung Chung Hei,North District Sports Association 1,9.0,18,2,1,1,12,0.5
,Lui Ho Yin,Latecomers,9.0,9,1,0,1,12,0.0
,Cheung Kee Wing,ZOMA,8.25,33,4,2,2,12,0.5
,Lam Wai Ming,Hong Kong Football Club 12B,7.5,30,4,1,3,12,0.25
,Mok Fuk Kam,South China Athletic Association,7.5,15,2,1,1,12,0.5
,Chan Kathleen Man Yiu,Hong Kong Racketlon Assoication 2,7.5,30,4,1,3,12,0.25
,Lee Tom Bo Yuen,ZOMA,6.0,24,4,2,2,12,0.5
,Yau Ka Man,Hong Kong Racketlon Assoication 2,6.0,24,4,1,3,12,0.25
,Huang Chi Hong,Latecomers,6.0,12,2,0,2,12,0.0
,Chau Yik Hong,Latecomers,6.0,24,4,0,4,12,0.0
,Wong Shuk Ting Ruby,Hong Kong Football Club 12B,6.0,18,3,0,3,12,0.0
,Chan Connie Chau Wah,CSD Squash Team,6.0,6,1,0,1,12,0.0
,Kandlakunta Raghunath,Winter Warriors,6.0,6,1,0,1,12,0.0
,Lam Jason Che Man,Hong Kong Football Club 12B,3.0,3,1,0,1,12,0.0
,Yuen Man Hin,Latecomers,3.0,6,2,0,2,12,0.0
,Li Zong Xiang,Star River 2,3.0,3,1,0,1,12,0.0
,Lam Chi On,CSD Squash Team,3.0,3,1,0,1,12,0.0
,Wong Yuk Ming,Latecomers,3.0,6,2,0,2,12,0.0
,Li Sek Kwai,Sea Bear,3.0,3,1,0,1,12,0.0
,Merien Kevin,Hong Kong Football Club 12B,1.5,3,2,0,2,12,0.0
,Wan Esther,Hong Kong Football Club 12B,0.0,0,1,0,1,12,0.0
,Tse Cheuk Lam,Latecomers,0.0,0,1,0,1,12,0.0
,Fung Ka Leung Wesley Nathan,North District Sports Association 1,0.0,0,0,0,0,12,0.0
,Lee Dominic Ho Chi,Alpha CUHK,0.0,0,0,0,0,12,0.0
,Wong Wai Keung,CSD Squash Team,0.0,0,0,0,0,12,0.0
,Mok Sui Kei,Alpha CUHK,0.0,0,0,0,0,12,0.0
,Suri Shivam,Winter Warriors,0.0,0,0,0,0,12,0.0
,Dhillon K Singh,CSD Squash Team,0.0,0,0,0,0,12,0.0
,Melwani Nitish Raju,Hong Kong Football Club 12B,0.0,0,0,0,0,12,0.0
,Chiu Chi Shing,Alpha CUHK,0.0,0,0,0,0,12,0.0
,Ooi Hui Hoon,Hong Kong Football Club 12B,0.0,0,0,0,0,12,0.0
,Rickett Nicholas Grant,Hong Kong Football Club 12A,0.0,0,0,0,0,12,0.0
